12 12
4 0
2 2
1 1 1 1 1 1 1 1 1 1 1 1
1 0 0 0 0 0 0 0 0 0 0 1
1 0 1 1 0 0 0 1 1 0 0 1
1 0 1 0 0 4 0 0 1 0 0 1
1 0 0 0 4 4 4 0 0 0 0 1
1 0 0 4 4 5 4 4 0 0 0 1
1 0 0 0 4 4 4 0 0 6 0 1
1 0 1 0 0 4 0 0 0 6 0 1
1 0 1 1 0 0 0 0 0 0 0 1
1 0 0 0 0 0 7 7 0 0 0 1
1 0 0 0 0 0 7 8 0 0 0 1
1 1 1 1 1 1 1 1 1 1 1 1