24 18
5 3
1 1
5 5 5 5 5 5 5 5 5 5 5 5 5 5 5 5 5 5 5 5 5 5 5 5
5 0 0 0 0 0 0 0 0 0 0 0 0 0 0 0 0 0 0 0 0 0 0 5
5 0 9 9 9 9 0 0 5 5 5 5 5 5 0 0 9 9 9 9 9 9 0 5
5 0 9 0 0 9 0 0 5 0 0 0 0 5 0 0 9 0 0 0 0 9 0 5
5 0 9 0 0 9 0 0 5 0 10 10 0 5 0 0 9 0 0 0 0 9 0 5
5 0 9 9 9 9 0 0 5 0 10 10 0 5 0 0 9 9 9 9 9 9 0 5
5 0 0 0 0 0 0 0 5 0 0 0 0 5 0 0 0 0 0 0 0 0 0 5
5 0 5 5 5 5 5 5 5 0 0 0 0 5 5 5 5 5 5 5 5 5 0 5
5 0 5 0 0 0 0 5 5 0 7 7 0 5 5 0 0 0 0 0 0 5 0 5
5 0 5 0 9 9 0 5 5 0 7 7 0 5 5 0 9 9 9 0 0 5 0 5
5 0 5 0 9 0 0 5 5 0 0 0 0 5 5 0 9 0 0 0 0 5 0 5
5 0 5 0 9 0 0 5 5 5 5 5 5 5 5 0 9 0 0 0 0 5 0 5
5 0 5 0 9 0 0 0 0 0 0 0 0 0 0 0 9 0 0 0 0 5 0 5
5 0 5 0 9 9 9 9 9 9 9 9 9 9 9 9 9 0 0 0 0 5 0 5
5 0 5 0 0 0 0 0 0 0 0 0 0 0 0 0 0 0 0 0 0 5 0 5
5 0 5 5 5 5 5 5 5 5 5 5 5 5 5 5 5 5 5 5 5 5 0 5
5 0 0 0 0 0 0 0 0 0 0 0 0 0 0 0 0 0 0 0 0 0 0 5
5 5 5 5 5 5 5 5 5 5 5 5 5 5 5 5 5 5 5 5 5 5 5 5