12 12
2 8
4 5
5 5 5 5 5 5 5 5 5 5 5 5
5 0 10 0 0 10 0 0 0 0 0 5
5 0 10 1 0 1 10 0 0 0 0 5
5 0 10 0 0 10 0 0 0 0 0 5
6 0 10 0 0 0 0 0 0 0 0 5
6 0 0 0 0 0 5 5 5 5 5 5
6 0 0 0 0 0 0 0 0 0 0 8
6 0 0 0 0 0 9 9 9 9 9 9
5 0 0 0 0 0 9 0 0 9 9 9
5 0 0 0 0 0 0 0 0 3 9 9
5 0 0 1 0 0 9 0 0 9 9 9
5 5 5 5 10 5 9 9 9 9 9 9